###########
# . # .   #
# $ # $  #
#  ###   #
##  $    ##
 #      #
 #@$ # ###
 #    . #
 #######