##########
#   #    #
# $ # $  #
#  ## #  #
##   # .##
 # ###   #
 #.$  #  #
 # @  #  #
#     #  ##
#        #
 #####  .#
     #####
