###########
# . # .   #
# $ # $  # 
#  ###   # 
##@ $    ##
 #      #  
 # $ # ### 
 #    . #  
 #######   
