########## 
#   #    # 
# $ # $  # 
# $## #  # 
##   # .## 
 # ###   # 
 #+   #  # 
 #    #  # 
#     #  ##
#        # 
 #####  .# 
     ##### 
