###########
#$. # .   #
#   # $  # 
#@ ###   # 
##  $    ##
 #      #  
 # $ # ### 
 #    . #  
 #######   
