###############
#   .   #     #
# # # ##### # #
#  $     $    #
### ### # ### #
#   #   #     #
#@      ##### #
#   !        !#
###############
