###### 
#@  .# 
# $ $.#
#    # 
###### 
