##### 
#   ##
#   ##
# !@# 
##### 
