##### 
#   ##
#   ##
#$.@# 
##### 
