##### 
#  @##
# $ ##
# . # 
##### 
