#####
#@  #
# $ #
# . #
#####
