#####
#@  ##
# $ ##
# . #
#####
