##########
#  .   #
#  $$   #
# # # #  #
#   #   ##
###$# # #
#.  $ @  #
#.    .###
##########
