###############
#   .   #     #
# # # ##### # #
# $ $ $   $   #
### ### # ### #
#   #   #     #
#   @   ##### #
#   .        .#
###############
